11111000000011100000000000011111
11100000000009000000000000000111
11111111111111100011111111111111
-1,-1,-1,1
11111111111111100011111111111111
1110A000S00000000000000000001111
11111111111111111111111111111111
2,-1,0,-1
11111000000011100000000000011111
11100000000009000000000000000111
11111111111111100011111111111111
-1,-1,-1,3
11111111111111100011111111111111
111000000009S0000000000000000111
11111111001111111111110011111111
-1,-1,2,4
11111111001111111111110011111111
11111000000B01111111110000011111
111111111110000S0000011111111111
-1,-1,3,5
11111111111000000000011111111111
111110000000000000000B000A011111
11111111111111111111111111111111
-1,6,4,-1
11111000000011100000000000011111
11100000000009000000000000000111
11111111111111100011111111111111
-1,-1,-1,7
11111111111111100L11111111111111
1110000S000000X00000000000000111
11111000000000000000000000011111
-1,-1,6,8
11111000000000000000000000011111
1110000000S000000000000000000111
11111111110011111111001111111111
-1,-1,7,9
111111111100111111110L1111111111
11100000000000009000B00000000111
11111111S01111111111110011111111
-1,-1,8,10
11111111001111111111110011111111
1110000000000X000009000000000111
11111111111111100011111111111111
-1,-1,9,11
11111111111111100011111111111111
111110A00X0000000000000000011111
11111111111111111111111111111111
12,-1,10,-1
11111000000011100000000000011111
11100000000009000000000000000111
11111111111111100011111111111111
-1,-1,-1,13
11111111111111100L11111111111111
1100000000000000000000000S000011
11100111111111111111111111100111
-1,-1,12,14
1110L111111111111111111111100111
110000001111111111111111B0000011
11111100011111111111111000111111
-1,-1,13,15
11111100L11111111111111000111111
111000000011111111111N0000000111
1100S011111111111111111111000011
-1,-1,14,16
11000011111111111111111111000011
1110000000000X000009000000000111
11111111111111100011111111111111
-1,-1,15,17
11111111111111100011111111111111
1100000009000000000000S000000011
11100111111111111111111111100111
-1,-1,16,18
1110011111111111111111111110L111
110000000900000000000000000S0011
111111111111000B0000111111111111
-1,-1,17,19
11111111111100000000111111111111
11111000000000111N0000000A011111
11111111111111111111111111111111
-1,20,18,-1
11111000000011100000000000011111
11100000000009000000000000000111
11111111111111100011111111111111
-1,-1,19,21
11111111111111100L11111111111111
0000X000000000000000000000000022
11111111111111111111111111111111
22,-1,20,-1
11111111111111111111111111111111
11000000000000S00000000000000000
111110000000000000X0000000011111
-1,21,-1,23
11111000000000000000000000011111
222222222200000S0000002222222222
11111111111111100111111111111111
-1,-1,22,24
1111111111111110L111111111111111
1100X000009000000000000000000011
111110011111111111111111N0011111
-1,-1,23,25
11111001111111111111111110L11111
220000000080000S0000000000000022
11111111111111000011111111111111
-1,-1,24,26
11111111111111000L11111111111111
22000000S00080000000000000000022
1111111100111111111111B011111111
-1,-1,25,27
11111111001111111111110011111111
110000000000X000000000000000A011
11111111111111111111111111111111
-1,28,26,-1
11111111111111111111111111111111
11000000000000000000000000000011
11111111111111111111111111111111
-1,-1,-1,-1